1111111111
1P00000001
11000C0011
1110000E11
11000C0011
11000C0011
11000C0011
1100111011
11001C1011
1111111111


